{
	"author": {
		"name": "Brian Wigginton",
		"email": "brianwigginton@gmail.com"
	},
	"map": {
		"name": "Maze!",
		"website": "http://www.bwigg.com/hbolo/maze/",
		"version": 0.1,
		"tile_size": 16,
		"impervious_tiles": [
			"#"
		],
		"tile_mappings": {
			"~": "0,0",
			"-": "0,16",
			"#": "16,0",
			"@": "16,16"
		},
		"layout": [
			"----------------------#-----------------",
			"----------------------#-----------------",
			"----------------------#-----------------",
			"----------------------#-----------------",
			"----------------------------------------",
			"----------------------------------------",
			"----------------------#-----------------",
			"----------------------#-----------------",
			"##########--############################",
			"----------------------#-----------------",
			"----------------------#-----------------",
			"----------------------#-----------------",
			"----------------------#-----------------",
			"----------------------#-----------------",
			"----------------------###########--#####",
			"----------------------------------------",
			"----------------------------------------",
			"---------------###----#-----------------",
			"----------------------#-----------------",
			"----------------------#-----------------",
			"----------------------#-----------------",
			"----------------------#-----------------",
			"----------------------#-----------------",
			"----------------------#-----------------",
			"----------------------#-----------------",
			"----------------------#-----------------",
			"@@@@@@@@@-------------#-----------------",
			"~~~~~~~~~~~~~~~~~~~~~~~~~~~~~~~~~~~~~~~~",
			"@@@@@@@@@@@@@@@@@@@@@@@@@@@@@@@@@@@@@@@@",
			"@@@@@@@@@@@@@@@@@@@@@@@@@@@@@@@@@@@@@@@@",
			"@@@@@@@@@@@@@@@@@@@@@@@@@@@@@@@@@@@@@@@@"
		]
	}
}
